111111111111111111111111111111111111111111111111
1CCCC000000000000000000000000000000G000000000001
1CCCCCCCCCC000000000G000CCCCCC0000000C000G000001
100000111000001111100000011111000000111111100001
10000010100G000000010000000000100000000000100001
1000000010000000000100000000001000000G0001000001
100000001000C000111000E00001110000C0000010000001
1000000010000000CCC00000000CCC000000000100C00001
100CCC001000000000010000000000100000001000000G01
1000000010000000G0C100000G000C100000010000000001
100000111110001111100000011111000000100000000001
1000000000000000P0000CCCCCC0000000000000G0000001
111111111111111111111111111111111111111111111111