111111111111111111111111111111111111111111111111
1000P0000CCCCCCCCCCCCCCCCC0000G00CCCCC0000000001
1000C0000000GG00000G0000000GG00000G00000000E00G1
111111111111111111111111111111111111111111111111