111111111111111111111111111111111111111111111111
100000000CCCCCCCCCCCCCCCCC0000G00CCCCC0000000001
1000C00000000G00000G0000000G000000G00000000E00G1
1000C0000000GG00000G00000000G00000000000000E00G1
1000C0000000G000000G0000000GG00000G00000000E00G1
1000C00000000G00000G00000000G00000G00000000E00G1
1000C0000000GG00000G0000000GG00000G00000000E00G1
1000C0000000G000000G00000000G00000G00000000E00G1
1000P00000000G00000G00000000000000G00000000E00G1
111111111111111111111111111111111111111111111111