111111111111111111111111111111111111111111111111
1CCCC000000000000000000000000000000C000000000001
1CCCCCCCCCC000000000C000CCCCCC0000000C000C000001
100000111000001111100000011111000000111111100001
10000010100C000000010000000000100000000000100001
1000000010000000000100000000001000000C0001000001
100000001000C000111000E00001110000C0000010000001
1000000010000000CCC00000000CCC000000000100C00001
100CCC001000000000010000000000100000001000000C01
1000000010000000C0C100000C000C100000010000000001
100000111110001111100000011111000000100000000001
1000000000000000P0000CCCCCC0000000000000C0000001
111111111111111111111111111111111111111111111111