111111111111111111111111111111111111111111111111
1000P0000CCCCCCCCCCCCCCCCC0000C00CCCCC0000000001
1000C0000000CC00000C0000000CC00000C00000000E00C1
111111111111111111111111111111111111111111111111