111111111111111111111111111111111111111111111111
100000000CCCCCCCCCCCCCCCCC0000C00CCCCC0000000001
1000C00000000C00000C0000000C000000C00000000E00C1
1000C0000000CC00000C00000000C00000000000000E00C1
1000C0000000C000000C0000000CC00000C00000000E00C1
1000C00000000C00000C00000000C00000C00000000E00C1
1000C0000000CC00000C0000000CC00000C00000000E00C1
1000C0000000C000000C00000000C00000C00000000E00C1
1000P00000000C00000C00000000000000C00000000E00C1
111111111111111111111111111111111111111111111111